1111111111111111111111111111111111111111111111111111111111111111111111
10P0000001000000000000000101001111111111111111111111111111111111111111
100000000100000000000000000E0C1111111111111111111111111111111111111111
1000000000000000C00000000111111111111111111111111111111111111111111111
1000000001000000000000000000001111111111111111111111111111111111111111
1000000001000000000000000000001111111111111111111111111111111111111111
1000000C0000000C000000000000001111111111111111111111111111111111111111
1111111111111111111111111111111111111111111111111111111111111111111111