1111111111111111111111111111111111111111
1P00000000000000000000C0000000000000C001
1011111101101110110111011011110110111101
1000C00000000000000000000000000000000001
1011011101110110111011011101110110111101
1000000000000000000000000000000000000001
1110111101011011010111101110110101111101
1000000000000000000000000C00000000000C01
1011101110110111011011101101110110110101
1000000000000000000000000000000000000001
1110111011011101101110110111011011011101
1000000000000C0000000000C000000000000C01
1011110110111101111011011011110110111101
1000000000000000000000000000000000000001
1111011011101111011101101110111101101111
1000C0000000000000000000000000000000C001
1011011110110111101101110110111101101101
100000000000000000E000000000000000000001
1110111011011110110111011011110110111101
1000000000000C000000000000000000000C0001
1000000000000000000000000000000000000001
1111111111111111111111111111111111111111
