11111111111111111111111111111
10000000E000000C00000C0000001
10100101001000001010010010101
1010010010101010001001C010101
1P0000000C00C00000000000000C1
11111111111111111111111111111
