111111111111111111111111111111
1P000000000000C000000000000001
101111110110111011011101111101
1000000000000000000000000C0001
101101110111011011101110110101
100000000000000000000000000001
111011110101101101011110111001
1000C00000000000000000C0000001
101110111011011101101110110101
100000000000000000000000000001
111011101101110110111011011101
1000000000000C00000000000C0001
101111011011110111101101101101
100000000000000000000000000001
100000000000000000000000000E01
111111111111111111111111111111
